#########################################
#                 #         #           #
# ############### # ####### # ######### #
# #             # # # #     # #       # #
# # ############# # # # ##### # ### # # #
# #               #   # #   # # # # # # #
# ##################### # # # # # # # # #
#                     # # #   #   # # # #
# ################# # # # ####### # ### #
# #               # # # # #     # #   # #
# # ### ######### # ### # # ### # ### # #
# #   # #S        #   # # #   # # # # # #
# ##### ############# # # ##### # # # # #
# #   #             #   # #   # # # # # #
# # # ########### # ##### # # # # # # # #
# # #             # #   # # #   # # # # #
# # ################# # # # ##### # # # #
# #                   #   #         # # #
# # ################################# # #
# # #                                 # #
# # # ############# ##### ########### # #
# # # #       #   # #   # #         # # #
# # # ####### # # # ### # # ####### # # #
# # #         # # #     # #   #   # # # #
# # ######### # # ##### # ### # # # # # #
# #   # #   # # #   # # # #E# # # # # # #
# ### # # ### # ### # # # # # ### # # # #
# # # # #   # # # # # # # # # #   # # # #
# # # # # # # # # # # # # # # # ### # # #
# # # #   #   # # # # # # # # #   # # # #
# # # # ####### # # # # # # # # # # # # #
# # # # #     # # # #   # #     # #   # #
# # # # # # # # # # ##### ############# #
# # # # # # # # # # #     #             #
# # # # ### ### # # # ### # #############
# #   #     #   #     #   #             #
# # ######### ############# ########### #
# #           #           #       #     #
# ############# ######### ######### ### #
#               #                   #   #
#########################################
